d000s000p000000
s0s0s0s000pppp0
s00000s0pp000p0
sss0sss00p0p0p0
s0s000s0pp0p000
0000s000p00p0pp
0s0ss0ssp0pp000
qq0000q0rrr00rr
0qqq0qq000r000r
000000qqr0rrr0r
0q0qq0q000r000r
qq00q0q0rrr0r0r
0qq0q0q00000r0r
00q0000qrrr000a
q000qq000000rrr